+------------------------------+
|                              |
| +++                      +++ |
| ++     +------------+     ++ |
|        +------------+        |
|                              |
|  +-+        +--+        +-+  |
<  |+|   +----++++----+   |+|  >
<  |+|   +----++++----+   |+|  >
|  +-+        +--+        +-+  |
|                              |
|        +------------+        |
| ++     +------------+    ++  |
| +++                     +++  |
|                              |
+------------------------------+